#######
#E!!!!#
#!!!!!#
#!!!#!#
#!!!!!#
#!!!!S#
#######
