############
#E!!!!!!!!!#
#!!!!!!!!!!#
#!!!!!!!!!!#
#!!!!!!!!!!#
#!!!!!!!!!!!
#!!!!!!!!!!#
#!!!!!!!!!!#
#!!!!!!!!!S#
############
