##################################################
#E!!!#############################################
####!#############################################
####!!############################################
#####!###########!!###############################
#####!###########!!!!##############!!#############
#####!###!!!!####!!#!!!###########!!!#############
#####!###!##!#####!###!!##########!#!!############
#####!###!##!#####!####!!#########!##!############
####!!###!##!!####!#####!#########!##!#####!!!!###
####!####!###!####!####!!########!!##!#####!##!###
###!!####!###!####!####!########!!###!#####!##!###
###!#####!###!####!####!#######!!####!#####!##!###
###!#####!!##!!###!####!#######!#####!#####!##!###
###!######!###!###!####!######!!#####!####!!##!###
###!######!###!###!####!!#####!#####!!####!###!###
###!######!###!!#!!#####!####!!#####!#####!###!###
###!!#####!####!!!######!!###!######!####!!###!###
####!!###!!##############!!##!######!####!####!###
#####!###!################!!!!######!####!####!###
#####!###!##########################!###!!####!###
#####!!!!!##########################!!##!#####!###
#######!!############################!!!!#####!###
##################!!!!!!###############!!#####!###
#################!!####!!!!!##################!###
###!!!!!!!!######!#########!!!################!###
##!!######!!#####!###########!!##############!!###
##!########!!####!############!!!###########!!####
##!#########!###!!##############!!!!#####!!!!#####
##!#########!###!##################!!!!!!!########
##!#########!!##!!######!!########################
##!##########!###!####!!!!!!######################
##!##########!!##!!!#!!####!######################
#!!######!####!!###!!!#####!!#####################
#!######!!!####!!###########!############!!#######
#!######!#!!####!!!#########!#####!!#####!!!##!!##
#!######!##!!#####!!!!#####!!####!!!!####!#!##!!!#
#!######!###!########!!!!!#!####!!##!###!!#!##!#!#
#!######!###!############!!!####!###!###!##!##!#!#
#!######!###!###################!###!##!!##!#!!#!#
#!######!###!###################!###!##!###!#!##!#
#!######!###!!##################!###!#!!###!!!#!!#
#!#####!!####!#####!!!##########!###!#!#######!!##
#!!####!#####!####!!#!!#####!!!#!###!#!######!!###
##!!!!!!#####!###!!###!#####!#!#!###!!!###!!!!####
#############!!!!!####!!###!!#!!!#######!!!#######
###############!!######!###!###!!######!!#########
#######################!!#!!###!!#####!!##########
########################!!!###########!!!!!!!!!!S#
##################################################
