##########
#E#!!!!!!#
#!#!######
#!!!!!#!!#
#####!#!##
#!!!!!#!!#
#!#####!##
#!!!!!!!!#
#######!##
#!!!!!!!!#
#!###!####
#!!!#!#!!#
###!#!#!##
#!!!#!!!!#
##########
