##########
#!!!!!!!!#
#!!!!!!!!#
#!S####!!#
#!!####!!#
#!!####!!#
#!!####!!#
#!!!!!!!!#
#!!!!!E!!#
##########
