#######
#E!!!!#
#!!#!##
#!#!###
#!###!#
#!!!!S#
#######
