###############
#E#############
#!#############
#!!!!!!!!!!!!!#
#!#####!#####!#
#!#####!#####!#
#!!!!!!!!!!!!!#
#!##!#####!##!#
#!##!#####!##!#
#!##!!!!!!!##!#
#!##!#####!##!#
#!##!#####!##!#
#!!!!!!!!!!!!!#
#!#####!#####!#
#!#####!#####!#
#!!!!!!!!!!!!!#
#############!#
#############S#
###############
